##################################
#####   ## ######     ############
####      #####    #    ##########
#####   #######  #################
#######    ##     ################
########      ##       ###########
#########    # ####   ############
##################################
##################################
