################################
#####   #  ######           ####
####      #####    #    ########
#####   #######  ########### ###
#          ##     ########    ##
###   ##       #       ###    ##
########     # ####   ######  ##
###        ########           ##
####             ####      #####
#####        #           #######
###############           ######
#########             ###  #####
######           #########  ####
##                           ###
#####                        ###
########                       #
###                   ###    ###
#     ####           ####    ###
####    #########             ##
##########          #####    ###
##   ####               #    ###
#                ###          ##
######          ########      ##
########     #######           #
###         #############    ###
## #         ###       ##   ####
##                            ##
#########                    ###
##########              ########
############       #############
###############   ##############
################################
